"a" = (/turf/open/space/basic,/area/space/nearstation)
"e" = (/obj/machinery/computer/shuttle/arrivals/recall{dir = 8},/obj/effect/turf_decal/bot,/turf/open/floor/iron/dark,/area/station/hallway/secondary/entry)
"m" = (/turf/open/floor/iron,/area/station/hallway/secondary/entry)
"q" = (/turf/open/floor/iron/dark/side{dir = 8},/area/station/hallway/secondary/entry)
"r" = (/obj/structure/railing{dir = 8},/turf/open/floor/iron/dark/corner{dir = 1},/area/station/hallway/secondary/entry)
"w" = (/obj/docking_port/stationary{dwidth = 1; height = 13; name = "arrivals"; shuttle_id = "arrivals_stationary"; width = 7},/turf/open/space/basic,/area/space)
"z" = (/obj/machinery/light/floor,/obj/effect/turf_decal/stripes{dir = 4},/obj/effect/turf_decal/stripes{dir = 8},/turf/open/floor/iron,/area/station/hallway/secondary/entry)
"A" = (/obj/effect/turf_decal/stripes{dir = 4},/obj/effect/turf_decal/caution{dir = 8},/turf/open/floor/iron,/area/station/hallway/secondary/entry)
"G" = (/obj/structure/table,/obj/item/lighter,/turf/open/floor/iron/dark,/area/station/hallway/secondary/entry)
"I" = (/obj/machinery/door/airlock/external{name = "Arrivals Dock"},/obj/effect/mapping_helpers/airlock/unres{dir = 4},/obj/effect/mapping_helpers/airlock/cyclelink_helper{dir = 4},/turf/open/floor/iron,/area/station/hallway/secondary/entry)
"K" = (/obj/effect/spawner/structure/window/reinforced,/turf/open/floor/plating,/area/station/hallway/secondary/entry)
"O" = (/turf/open/floor/engine/hull/reinforced,/area/space/nearstation)
"R" = (/obj/structure/railing{dir = 8},/turf/open/floor/iron/dark/corner{dir = 8},/area/station/hallway/secondary/entry)
"V" = (/turf/open/space/basic,/area/space)
"W" = (/obj/machinery/door/airlock/external{name = "Arrivals Dock"; space_dir = 4},/obj/effect/mapping_helpers/airlock/cyclelink_helper{dir = 8},/turf/open/floor/iron,/area/station/hallway/secondary/entry)
"Z" = (/obj/item/kirbyplants/random,/turf/open/floor/iron/dark,/area/station/hallway/secondary/entry)

(1,1,1) = {"
aaaaOVVV
KKKKKKVV
qmAIzWVV
rmKKKKVV
KKKaOVVV
ZKaaOVVV
eKaaOVVV
GKaaOVVV
KKKaOVVV
RmKKKKVV
qmAIzWVV
KKKKKKVV
aaaaOVVw
"}
