//MAP CONVERTED BY dmm2tgm.py THIS HEADER COMMENT PREVENTS RECONVERSION, DO NOT REMOVE
"aR" = (
/obj/effect/spawner/structure/window/reinforced/plasma,
/turf/open/floor/plating,
/area/station/science/research/abandoned)
"bz" = (
/obj/structure/disposaloutlet{
	dir = 4
	},
/obj/structure/disposalpipe/trunk{
	dir = 8
	},
/turf/open/floor/engine/airless,
/area/station/science/research/abandoned)
"dn" = (
/obj/effect/decal/cleanable/dirt/dust,
/obj/item/radio/intercom/directional/south,
/obj/effect/turf_decal/trimline/purple/filled/line,
/turf/open/floor/iron/dark,
/area/station/science/research/abandoned)
"dy" = (
/obj/structure/railing/corner/end/flip{
	dir = 8
	},
/turf/open/misc/asteroid/snow/icemoon,
/area/icemoon/underground/explored)
"dL" = (
/obj/machinery/shower/directional/west{
	name = "emergency shower"
	},
/obj/effect/decal/cleanable/dirt/dust,
/obj/machinery/atmospherics/components/unary/vent_pump/on/layer4,
/obj/effect/turf_decal/trimline/purple/filled/line{
	dir = 4
	},
/turf/open/floor/iron/dark,
/area/station/science/research/abandoned)
"eJ" = (
/turf/open/floor/engine/airless,
/area/station/science/research/abandoned)
"fp" = (
/obj/structure/cable,
/obj/machinery/power/terminal{
	dir = 4
	},
/obj/effect/decal/cleanable/dirt/dust,
/obj/effect/turf_decal/stripes/line{
	dir = 4
	},
/obj/effect/turf_decal/stripes/line{
	dir = 8
	},
/obj/structure/cable/layer1,
/turf/open/floor/catwalk_floor/iron_dark,
/area/station/science/research/abandoned)
"fC" = (
/obj/structure/cable,
/obj/effect/decal/cleanable/dirt/dust,
/obj/item/paper/crumpled,
/obj/structure/cable/layer1,
/turf/open/floor/catwalk_floor/iron_dark,
/area/station/science/research/abandoned)
"hp" = (
/obj/effect/decal/cleanable/dirt/dust,
/obj/effect/turf_decal/trimline/purple/filled/line,
/turf/open/floor/iron/dark,
/area/station/science/research/abandoned)
"hO" = (
/obj/machinery/atmospherics/pipe/smart/manifold4w/scrubbers/hidden/layer2,
/obj/machinery/atmospherics/pipe/smart/manifold4w/supply/hidden/layer4,
/obj/effect/decal/cleanable/dirt/dust,
/obj/effect/turf_decal/caution{
	dir = 8
	},
/obj/effect/turf_decal/trimline/purple/filled/warning{
	dir = 4
	},
/turf/open/floor/iron/dark,
/area/station/science/research/abandoned)
"jn" = (
/obj/structure/table/reinforced/rglass,
/obj/item/scalpel/supermatter{
	name = "Warpstone Chisel"
	},
/obj/effect/decal/cleanable/dirt/dust,
/obj/item/multitool,
/obj/machinery/camera/autoname/directional/west,
/obj/effect/turf_decal/trimline/purple/filled/line{
	dir = 8
	},
/turf/open/floor/iron/dark,
/area/station/science/research/abandoned)
"jv" = (
/obj/structure/cable,
/obj/effect/decal/cleanable/dirt/dust,
/obj/machinery/atmospherics/pipe/smart/manifold4w/scrubbers/hidden/layer2,
/obj/machinery/atmospherics/pipe/smart/manifold4w/supply/hidden/layer4,
/turf/open/floor/catwalk_floor/iron_dark,
/area/station/science/research/abandoned)
"jF" = (
/obj/effect/decal/cleanable/dirt/dust,
/obj/machinery/atmospherics/pipe/smart/manifold4w/scrubbers/hidden/layer2,
/obj/machinery/atmospherics/pipe/smart/manifold4w/supply/hidden/layer4,
/turf/open/floor/catwalk_floor/iron_dark,
/area/station/science/research/abandoned)
"ko" = (
/obj/structure/table/reinforced/rglass,
/obj/effect/decal/cleanable/dirt/dust,
/obj/item/paper,
/obj/item/disk{
	name = "Research Data";
	pixel_x = 7
	},
/obj/item/pen/fourcolor,
/obj/effect/turf_decal/trimline/purple/filled/line{
	dir = 4
	},
/obj/structure/cable/multilayer/connected,
/turf/open/floor/iron/dark,
/area/station/science/research/abandoned)
"kI" = (
/obj/structure/table_frame,
/obj/machinery/light/cold/directional/west,
/obj/effect/decal/cleanable/dirt/dust,
/obj/effect/turf_decal/trimline/purple/filled/line{
	dir = 8
	},
/turf/open/floor/iron/dark,
/area/station/science/research/abandoned)
"lb" = (
/obj/effect/decal/cleanable/dirt/dust,
/obj/machinery/atmospherics/components/unary/vent_scrubber/on/layer2,
/turf/open/floor/iron/dark,
/area/station/science/research/abandoned)
"mN" = (
/obj/effect/decal/cleanable/dirt/dust,
/obj/effect/turf_decal/trimline/purple/filled/corner,
/turf/open/floor/iron/dark,
/area/station/science/research/abandoned)
"ne" = (
/obj/machinery/atmospherics/components/unary/vent_pump/layer4,
/turf/open/floor/engine/airless,
/area/station/science/research/abandoned)
"nt" = (
/obj/machinery/power/energy_accumulator/tesla_coil/anchored,
/turf/open/floor/engine/airless,
/area/station/science/research/abandoned)
"nJ" = (
/obj/effect/turf_decal/trimline/purple/filled/line{
	dir = 9
	},
/turf/open/floor/iron/dark,
/area/station/science/research/abandoned)
"nM" = (
/obj/structure/lattice/catwalk,
/obj/structure/railing,
/turf/open/openspace/icemoon/keep_below,
/area/icemoon/underground/explored)
"os" = (
/obj/effect/decal/cleanable/dirt/dust,
/mob/living/basic/mouse/rat,
/turf/open/floor/iron/dark,
/area/station/science/research/abandoned)
"ph" = (
/obj/machinery/airalarm/directional/north,
/obj/effect/mapping_helpers/airalarm/all_access,
/obj/structure/cable,
/obj/effect/decal/cleanable/dirt/dust,
/obj/item/storage/bag/trash/filled,
/obj/structure/cable/layer1,
/turf/open/floor/catwalk_floor/iron_dark,
/area/station/science/research/abandoned)
"pj" = (
/obj/effect/decal/cleanable/dirt/dust,
/obj/machinery/atmospherics/pipe/smart/manifold4w/supply/hidden/layer4,
/obj/machinery/atmospherics/pipe/smart/manifold4w/scrubbers/hidden/layer2,
/obj/structure/cable,
/obj/effect/turf_decal/trimline/purple/filled/corner,
/obj/effect/turf_decal/trimline/purple/filled/corner{
	dir = 8
	},
/turf/open/floor/catwalk_floor/iron_dark,
/area/station/science/research/abandoned)
"pK" = (
/obj/structure/chair/office{
	dir = 1
	},
/obj/effect/decal/cleanable/dirt/dust,
/obj/machinery/requests_console/auto_name/directional/south,
/obj/effect/turf_decal/trimline/purple/filled/line,
/obj/item/shard{
	pixel_x = -8;
	pixel_y = 8
	},
/turf/open/floor/iron/dark,
/area/station/science/research/abandoned)
"rd" = (
/obj/machinery/atmospherics/pipe/smart/manifold4w/scrubbers/hidden/layer2,
/obj/machinery/atmospherics/pipe/smart/manifold4w/supply/hidden/layer4,
/obj/effect/decal/cleanable/dirt/dust,
/turf/open/floor/catwalk_floor/iron_dark,
/area/station/science/research/abandoned)
"rt" = (
/obj/effect/mapping_helpers/airlock/cyclelink_helper{
	dir = 4
	},
/obj/machinery/door/airlock/plasma{
	name = "Outer Warpstone Lock"
	},
/obj/machinery/atmospherics/pipe/smart/manifold4w/scrubbers/hidden/layer2,
/obj/machinery/atmospherics/pipe/smart/manifold4w/supply/hidden/layer4,
/obj/effect/mapping_helpers/airlock/locked,
/obj/effect/turf_decal/trimline/purple/filled/end{
	dir = 8
	},
/turf/open/floor/iron/dark,
/area/station/science/research/abandoned)
"sV" = (
/obj/machinery/atmospherics/pipe/smart/manifold4w/scrubbers/hidden/layer2,
/obj/machinery/atmospherics/pipe/smart/manifold4w/supply/hidden/layer4,
/obj/machinery/door/firedoor/heavy,
/obj/effect/turf_decal/trimline/purple/filled/end{
	dir = 4
	},
/obj/machinery/light/small/broken/directional/north,
/turf/open/floor/iron/dark,
/area/station/science/research/abandoned)
"sY" = (
/obj/structure/table/reinforced/rglass,
/obj/item/modular_computer/laptop/preset/civilian,
/obj/effect/decal/cleanable/dirt/dust,
/obj/item/trash/can{
	pixel_y = 11
	},
/obj/effect/turf_decal/trimline/purple/filled/line{
	dir = 6
	},
/turf/open/floor/iron/dark,
/area/station/science/research/abandoned)
"tK" = (
/obj/structure/table_frame,
/obj/effect/decal/cleanable/dirt/dust,
/obj/structure/sign/poster/official/random/directional/west,
/obj/effect/turf_decal/trimline/purple/filled/line{
	dir = 8
	},
/turf/open/floor/iron/dark,
/area/station/science/research/abandoned)
"uq" = (
/obj/machinery/power/emitter/welded{
	dir = 1;
	cable_layer = 1
	},
/obj/effect/decal/cleanable/dirt/dust,
/obj/effect/turf_decal/stripes/end,
/obj/structure/cable/layer1,
/turf/open/floor/plating,
/area/station/science/research/abandoned)
"uX" = (
/obj/machinery/power/energy_accumulator/grounding_rod/anchored,
/obj/machinery/atmospherics/pipe/smart/manifold4w/scrubbers/hidden/layer2,
/obj/machinery/atmospherics/pipe/smart/manifold4w/supply/hidden/layer4,
/turf/open/floor/engine/airless,
/area/station/science/research/abandoned)
"vj" = (
/obj/effect/spawner/structure/window/reinforced,
/obj/machinery/door/firedoor,
/turf/open/floor/plating,
/area/station/science/research/abandoned)
"vx" = (
/obj/structure/lattice/catwalk,
/obj/structure/railing{
	dir = 10
	},
/turf/open/openspace/icemoon/keep_below,
/area/icemoon/underground/explored)
"vO" = (
/obj/effect/decal/cleanable/dirt/dust,
/obj/machinery/portable_atmospherics/canister/halon,
/obj/effect/turf_decal/box,
/obj/effect/turf_decal/trimline/purple/filled/line{
	dir = 8
	},
/turf/open/floor/iron/dark,
/area/station/science/research/abandoned)
"xm" = (
/obj/structure/frame/machine,
/obj/effect/decal/cleanable/dirt/dust,
/obj/effect/turf_decal/trimline/purple/filled/line{
	dir = 1
	},
/turf/open/floor/iron/dark,
/area/station/science/research/abandoned)
"xx" = (
/obj/machinery/atmospherics/components/unary/vent_scrubber/on/layer2,
/turf/open/floor/engine/airless,
/area/station/science/research/abandoned)
"ya" = (
/obj/structure/table/reinforced/rglass,
/obj/effect/decal/cleanable/dirt/dust,
/obj/item/storage/box/gorillacubes,
/obj/item/analyzer/ranged,
/obj/effect/turf_decal/trimline/purple/filled/line{
	dir = 5
	},
/turf/open/floor/iron/dark,
/area/station/science/research/abandoned)
"yO" = (
/obj/effect/decal/cleanable/dirt/dust,
/obj/machinery/atmospherics/components/unary/vent_pump/on/layer4{
	dir = 4
	},
/turf/open/floor/iron/dark,
/area/station/science/research/abandoned)
"za" = (
/obj/machinery/light/cold/directional/south,
/obj/machinery/firealarm/directional/south,
/obj/effect/decal/cleanable/dirt/dust,
/obj/effect/turf_decal/trimline/purple/filled/line,
/turf/open/floor/iron/dark,
/area/station/science/research/abandoned)
"zn" = (
/obj/machinery/light/red/directional/south,
/turf/open/floor/engine/airless,
/area/station/science/research/abandoned)
"zz" = (
/turf/open/misc/asteroid/snow/icemoon,
/area/icemoon/underground/explored)
"zD" = (
/obj/structure/marker_beacon/burgundy{
	name = "landing marker"
	},
/obj/effect/mapping_helpers/no_atoms_ontop,
/turf/open/floor/plating/snowed/smoothed/icemoon,
/area/icemoon/underground/explored)
"Ap" = (
/obj/machinery/light/cold/directional/south,
/obj/machinery/light_switch/directional/south,
/obj/effect/decal/cleanable/dirt/dust,
/obj/effect/turf_decal/trimline/purple/filled/line,
/turf/open/floor/iron/dark,
/area/station/science/research/abandoned)
"Bv" = (
/turf/closed/wall/r_wall,
/area/station/science/research/abandoned)
"BE" = (
/obj/structure/cable,
/obj/effect/decal/cleanable/dirt/dust,
/obj/structure/extinguisher_cabinet/directional/north,
/obj/structure/cable/layer1,
/turf/open/floor/catwalk_floor/iron_dark,
/area/station/science/research/abandoned)
"BS" = (
/obj/effect/decal/cleanable/dirt/dust,
/obj/machinery/atmospherics/components/unary/vent_scrubber/on/layer2{
	dir = 8
	},
/turf/open/floor/iron/dark,
/area/station/science/research/abandoned)
"Cq" = (
/obj/effect/decal/cleanable/dirt/dust,
/obj/structure/showcase/horrific_experiment,
/obj/effect/turf_decal/trimline/purple/filled/line{
	dir = 1
	},
/turf/open/floor/iron/dark,
/area/station/science/research/abandoned)
"Eb" = (
/obj/machinery/power/supermatter_crystal/hugbox{
	color = "green";
	name = "Synthetic Warp Stone Crystal"
	},
/turf/open/floor/engine/airless,
/area/station/science/research/abandoned)
"Ex" = (
/obj/machinery/atmospherics/pipe/smart/manifold4w/scrubbers/hidden/layer2,
/obj/item/clothing/glasses/welding,
/obj/effect/mob_spawn/corpse/human/charredskeleton,
/turf/open/floor/engine/airless,
/area/station/science/research/abandoned)
"Gq" = (
/obj/machinery/light/red/directional/north,
/turf/open/floor/engine/airless,
/area/station/science/research/abandoned)
"Hb" = (
/obj/effect/decal/cleanable/dirt/dust,
/obj/machinery/portable_atmospherics/canister/freon,
/obj/effect/turf_decal/box,
/obj/effect/turf_decal/trimline/purple/filled/line{
	dir = 10
	},
/turf/open/floor/iron/dark,
/area/station/science/research/abandoned)
"In" = (
/obj/effect/decal/cleanable/dirt/dust,
/turf/open/floor/iron/dark,
/area/station/science/research/abandoned)
"JD" = (
/obj/machinery/disposal/bin,
/obj/structure/disposalpipe/trunk{
	dir = 4
	},
/obj/effect/decal/cleanable/dirt/dust,
/obj/effect/turf_decal/trimline/purple/filled/line{
	dir = 6
	},
/turf/open/floor/iron/dark,
/area/station/science/research/abandoned)
"KA" = (
/obj/machinery/atmospherics/pipe/smart/manifold4w/scrubbers/hidden/layer2,
/obj/machinery/atmospherics/pipe/smart/manifold4w/supply/hidden/layer4,
/turf/open/floor/engine/airless,
/area/station/science/research/abandoned)
"KX" = (
/obj/effect/decal/cleanable/dirt/dust,
/obj/machinery/destructive_scanner,
/obj/effect/turf_decal/stripes/end,
/obj/effect/turf_decal/trimline/purple/filled/line{
	dir = 1
	},
/turf/open/floor/iron/dark,
/area/station/science/research/abandoned)
"LX" = (
/obj/effect/mapping_helpers/airlock/cyclelink_helper{
	dir = 8
	},
/obj/machinery/door/airlock/plasma{
	name = "Inner Warpstone Lock"
	},
/obj/structure/fans/tiny/invisible,
/obj/machinery/atmospherics/pipe/smart/manifold4w/scrubbers/hidden/layer2,
/obj/machinery/atmospherics/pipe/smart/manifold4w/supply/hidden/layer4,
/obj/effect/mapping_helpers/airlock/locked,
/turf/open/floor/catwalk_floor/iron_dark,
/area/station/science/research/abandoned)
"Nx" = (
/obj/effect/decal/cleanable/dirt/dust,
/obj/machinery/atmospherics/pipe/smart/manifold4w/scrubbers/hidden/layer2,
/obj/machinery/atmospherics/pipe/smart/manifold4w/supply/hidden/layer4,
/obj/effect/gibspawner/robot,
/turf/open/floor/catwalk_floor/iron_dark,
/area/station/science/research/abandoned)
"Nz" = (
/obj/structure/closet/firecloset/wall{
	pixel_x = -28
	},
/obj/effect/turf_decal/trimline/purple/filled/line{
	dir = 8
	},
/turf/open/floor/iron/dark,
/area/station/science/research/abandoned)
"Ou" = (
/obj/machinery/door/airlock/science{
	name = "Abandoned Warp Stone Lab"
	},
/obj/machinery/door/firedoor,
/obj/machinery/atmospherics/pipe/smart/manifold4w/supply/hidden/layer4,
/obj/machinery/atmospherics/pipe/smart/manifold4w/scrubbers/hidden/layer2,
/obj/structure/cable,
/obj/effect/turf_decal/trimline/purple/filled/end,
/obj/effect/mapping_helpers/airlock/abandoned,
/obj/effect/mapping_helpers/airlock/access/any/science/maintenance,
/turf/open/floor/iron/dark,
/area/station/science/research/abandoned)
"QK" = (
/obj/effect/decal/cleanable/dirt/dust,
/obj/machinery/newscaster/directional/south,
/obj/item/trash/energybar,
/obj/effect/turf_decal/trimline/purple/filled/line,
/turf/open/floor/iron/dark,
/area/station/science/research/abandoned)
"RG" = (
/obj/effect/decal/cleanable/dirt/dust,
/mob/living/basic/mouse/rat,
/obj/machinery/atmospherics/pipe/smart/manifold4w/supply/hidden/layer4,
/obj/machinery/atmospherics/pipe/smart/manifold4w/scrubbers/hidden/layer2,
/obj/structure/cable,
/turf/open/floor/catwalk_floor/iron_dark,
/area/station/science/research/abandoned)
"RR" = (
/obj/effect/decal/cleanable/dirt/dust,
/obj/effect/turf_decal/trimline/purple/filled/line{
	dir = 8
	},
/turf/open/floor/iron/dark,
/area/station/science/research/abandoned)
"TZ" = (
/obj/machinery/power/apc/auto_name/directional/north{
	cable_layer = 1
	},
/obj/structure/cable,
/obj/effect/decal/cleanable/dirt/dust,
/obj/machinery/atmospherics/pipe/smart/manifold4w/scrubbers/hidden/layer2,
/obj/machinery/atmospherics/pipe/smart/manifold4w/supply/hidden/layer4,
/obj/structure/cable/layer1,
/turf/open/floor/catwalk_floor/iron_dark,
/area/station/science/research/abandoned)
"Wa" = (
/obj/machinery/light/cold/directional/south,
/obj/effect/decal/cleanable/dirt/dust,
/obj/effect/turf_decal/trimline/purple/filled/line,
/turf/open/floor/iron/dark,
/area/station/science/research/abandoned)
"We" = (
/obj/structure/frame/computer{
	anchored = 1;
	broken = 1;
	can_be_unanchored = 1
	},
/obj/effect/decal/cleanable/dirt/dust,
/turf/open/floor/iron/dark,
/area/station/science/research/abandoned)
"WL" = (
/obj/machinery/power/smes/full,
/obj/effect/decal/cleanable/dirt/dust,
/obj/effect/turf_decal/trimline/purple/filled/line{
	dir = 4
	},
/obj/structure/cable,
/turf/open/floor/iron/dark,
/area/station/science/research/abandoned)
"WW" = (
/obj/effect/decal/cleanable/dirt/dust,
/obj/structure/trash_pile,
/turf/open/floor/iron/dark,
/area/station/science/research/abandoned)
"Xj" = (
/obj/effect/decal/cleanable/dirt/dust,
/obj/effect/landmark/atmospheric_sanity/ignore_area,
/turf/open/floor/iron/dark,
/area/station/science/research/abandoned)
"Xo" = (
/obj/structure/disposalpipe/segment{
	dir = 4
	},
/obj/effect/spawner/structure/window/reinforced/plasma,
/turf/open/floor/plating,
/area/station/science/research/abandoned)
"XD" = (
/obj/effect/landmark/blobstart,
/obj/machinery/atmospherics/pipe/smart/manifold4w/supply/hidden/layer4,
/turf/open/floor/engine/airless,
/area/station/science/research/abandoned)
"XG" = (
/obj/effect/decal/cleanable/dirt/dust,
/obj/structure/closet/radiation,
/obj/effect/turf_decal/trimline/purple/filled/corner{
	dir = 4
	},
/turf/open/floor/iron/dark,
/area/station/science/research/abandoned)

(1,1,1) = {"
zz
zz
zz
zz
zz
zz
zz
zz
zz
zz
zz
"}
(2,1,1) = {"
Bv
Bv
Bv
Bv
Bv
Bv
Bv
vj
vj
Bv
zz
"}
(3,1,1) = {"
Bv
nJ
RR
Nz
kI
jn
tK
vO
Hb
Bv
zz
"}
(4,1,1) = {"
Bv
xm
WW
In
In
os
In
In
hp
Bv
zz
"}
(5,1,1) = {"
Bv
xm
os
lb
rd
jF
Nx
Xj
hp
Bv
zz
"}
(6,1,1) = {"
Bv
KX
mN
dL
hO
XG
jv
RG
pj
Ou
vx
"}
(7,1,1) = {"
Bv
Cq
Wa
Bv
rt
Bv
jv
yO
za
Bv
nM
"}
(8,1,1) = {"
Bv
ya
JD
Bv
sV
Bv
TZ
jF
hp
Bv
nM
"}
(9,1,1) = {"
Bv
aR
Xo
Bv
LX
Bv
ph
BS
Ap
Bv
dy
"}
(10,1,1) = {"
Bv
nt
bz
eJ
KA
Bv
BE
In
dn
Bv
zz
"}
(11,1,1) = {"
Bv
Gq
ne
XD
uX
aR
fC
We
QK
Bv
zz
"}
(12,1,1) = {"
Bv
eJ
Eb
xx
Ex
aR
fp
uq
pK
Bv
zz
"}
(13,1,1) = {"
Bv
eJ
eJ
eJ
zn
Bv
WL
ko
sY
Bv
zz
"}
(14,1,1) = {"
Bv
Bv
Bv
Bv
Bv
Bv
Bv
Bv
Bv
Bv
zD
"}
